timer  250
timerfantome 20

CCCCCCCCCCCCCCCCCCCCC
C E                 C
C C C C C C C C C C C
C MMMMMMMMMMMMMMMMM C
C CMCMCMCMCMCMCMCMC C
C MMMMMMMMMMMMMMMMM C
C CMCMCMCMCMCMCMCMC C
C MMMMMMMMMMMMMMMMM C
C CMCMCMCMCMCMCMCMC C
C MMMMMMMMMMMMMMMMM C
C CMCMCMCMCMCMCMCMC C
C             P     C
C CMCMCMCMCMCMCMCMC C
C MMMMMMMMMMMMMMMMM C
C CMCMCMCMCMCMCMCMC C
C MMMMMMMMMMMMMMMMM C
C CMCMCMCMCMCMCMCMC C
C MMMMMMMMMMMMMMMMM C
C CMCMCMCMCMCMCMCMC C
C                 E C
CCCCCCCCCCCCCCCCCCCCC