timer  1000
timerfantome 40

CCCCCCCCCCCCCCCCCCCCCCCCCCCC
CC MMMMMMMMMMMM  MMMMMMME CC
CC C   MCM   CM  C   MMM  CC
CC MMMMMMMCMMMME MCMCMCM  CC
CT                        TC
CC MMMMMMMMMMCM  CMMMMMMM CC
CC CMMCMMCMCMCCN C     CM CC
CC MM     MMMMM  MMMMMMMM CC
CC MMMCMMMCMCMC  C     CM CCCCCCCCCC
CC MM     MMMMM  MMMMMMMM         CC
CC CMMCMMMCMCMM  CMCCMCCMCMCMMM   CC
CC MMMMMMMMMMMM  M   MCCM   MEM   CC
CCNCCCCCCCCCCCC  CMCMCMCMMMMMMM   CC
CT             P                  TC
CC CMCMCMCMCMCM  MCMCMCMC  MCMCMCMCC
CC CMMMMMMMMMMM  MMMMMCCC  CM    MCC
CC C C C C C CC  MMMMMCCC  MMMMMMMCC
CC M M M M M MM  EM M M M  MMM MMMCC
CC C C C C C MM  MC C M M  MMM CCCCC
CC M M M M M MM  MM M M C  MCM MCMCC
CC C C C C C CC NCC C C CN CCC MCMCC
CC MMMMMMMMMMMM  MMMMMMMM  MMM CMMCC
CC MCMMCMCMCMCM  MMCCCCMM  MCMMCMMCC
CT  E                             TC
CCCCCCCCCCCCCCCCCCCCCCCCCCCCCCCCCCCC