timer  1000
timerfantome 40

CCCCCCCCCCCCCCCCCCCCCCCC
CT         E          TC
CC  MMC  CMCMM  CM CC CC
CC  MMM  MMMMM  MM CM CC
CCN CCC  CCCCC  CM CM CC
CT             P      TC
CC CMCM  MCMCM  MC CM CC
CC CMMM  MMMMM  MM CC CC
CC C CC  CC CC NMM CC CC
CC M MM  MM MM  EM MM CC
CC C CM NCC MM  MC MM CC
CC M MM  MM MM  MM MM CC
CT                    TC
CC MMMMN MMMMM  MM MM CC
CC MCMM  MCMCM NMC CM CC
CT E                  TC
CCCCCCCCCCCCCCCCCCCCCCCC