timer  1000
timerfantome 40

CCCCCCCCCCCCCCCCCCCCCCCCCCC
C MMMMMMMMMMMM   MMMMMMME C
C C   MCM   CM   C   MMM  C
C MMMMMMMCMMMM E MCMCMCM  C
C                         C
C MMMMMMMMMMCM   CMMMMMMM C
C CMMCMMMCMCMC   C     CM C
C MM     MMMMM   MMMMMMMM C
C MMMCMMMCMCMC   C     CM CCCCCCCCC
C MM     MMMMM   MMMMMMMM         C
C CMMCMMMCMCMM   CMCCMCCMCMCMMM   C
C MMMMMMMMMMMM   M   MCCM   MEM   C
CMCCCCCCCCCCCC   CMCMCMCMMMMMMM   C
C              P                  C
C CMCMCMCMCMCM   MCMCMCMC  MCMCMCMC
C CMMMMMMMMMMM   MMMMMCCC  CM    MC
C C C C C C CC   MMMMMCCC  MMMMMMMC
C M M M M M MM   EM M M M  MMM MMMC
C C C C C C MM   MC C M M  MMM CCCC
C M M M M M MM   MM M M C  MCM MCMC
C C C C C C CC   CC C C C  CCC MCMC
C MMMMMMMMMMMM   MMMMMMMM  MMM CMMC
C MCMMCMCMCMCM   MMCCCCMM  MCMMCMMC
C E                               C
CCCCCCCCCCCCCCCCCCCCCCCCCCCCCCCCCCC