timer  1000
timerfantome 40

CCCCCCCCCCCCCCCCCCCCCCCC
C  E                   C
C  MMC  CMCMM  CMCCMCC C
C  MMM  MMMMM  M   MCM C
C  CCC  CCCCC  CMCMCMC C
C             P        C
C CMCM  MCMCM  MCMCMCM C
C CMMM  MMMMM  MMMMMCC C
C C CC  CC CC  MMMMMCC C
C M MM  MM MM  EM M MM C
C C CM  CC MM  MC C MM C
C M MM  MM MM  MM M MM C
C                      C
C MMMM  MMMMM  MMMMMMM C
C MCMM  MCMCM  MMCCCCM C
C E                    C
CCCCCCCCCCCCCCCCCCCCCCCC